0000000000
0000111110
1110100010
0010001000
0010111000
0011100000
0110100000
0100111000
0110001000
0010000000
